1111111111111
10100000100C1
1000010010001
100101E000001
1111111111111