1111111111111
10010000000C1
10000111110011
1P0011E000U01
1111111111111