1111111111
10101111C1
1000111111
1P01E00011
1111111111