11111111111111111111111111111111111111111111111111111111111
1E00001000P0P0000000000010C00000000000000100000000000000001
10100101001000001010010000000010000000000000000000000010101
10100100101010100010010000000000000000000000000000000010101
1P0000000C00C00000000000000010000000000001000000000000000C1
1000001000P0PPPPP000010C00000000000000000100000000000000001
10100101001000001010010000010000000000000000000000000010101
10100100101010100010010000000100000000000000000000000010101
1P0000000C00C00000000000000010000000001000000000000000000C1
1000001000P0PPPPP000010C00000000000000100000000000000000001
10100101001000001010010000010000000000000000000000000010101
10100100101010100010010000000100000000000000000000010000101
1P0000000C00C00000000000000010000000001000000000000000000C1
1000001000P0PPPPP000010C00000000000000100000000000000000001
10100101001000001010010000010000000000000000000000010000101
10100100101010100010010000000100000000000000000000010100001
1P0000000C00C00000000000000010000000001000000000000000000C1
1000001000P0PPPPP000010C00000000000000100000000000000000001
10100101001000001010010000010000000000000000000000010000101
10100100101010100010010000000100000000000000000000000010101
10100100101010100010010000000100000000000000000000000010101
10100100101010100010010000000100000000000000000000000010101
10100100101010100010010000000100000000000000000000000010101
1P0000000C00C00000000000000010000000001000000000000000000C1
1000001000P0PPPPP000010C00000000000000100000000000000000001
11111111111111111111111111111111111111111111111111111111111